........
...#.#..
..#...#.
.#.*#...
...#*.#.
.#...#..
..#.#.*.
........