........
.###.##.
........
..####..
#....#..
##.#....
#..#.###
#.##...*

