.....#...*
.##..#..#.
.#*...#.#.
....#.....
...##.#..#
..#*......
...##..#..
*.##....*.
......#..#
....#...##
