...........#...#
.###.##.#.##.#.#
........#....*.#
..####..#.#....#
#....#..*....#..
##.#......##...*
#..#.####..##...
#.##...*.#..#...
#*..#....##..##.
#.......#..#..#.
..#.###....#....
.##...#..#..#.#.
...##.##..#.##..
##...*.......#..
...#...#.#.#..#.
#....#..#.....##